xlt|application/vnd.ms-excel
xlw|application/vnd.ms-excel
ksp|application/vnd.kde.kspread
stylus|text/stylus
dfac|application/vnd.dreamfactory
opus|audio/ogg
cco|application/x-cocoa
atomsvc|application/atomsvc+xml
emma|application/emma+xml
hpid|application/vnd.hp-hpid
ei6|application/vnd.pg.osasli
cct|application/x-director
xml|text/xml
jxsi|image/jxsi
tei|application/tei+xml
mxf|application/mxf
shtml|text/html
jxss|image/jxss
glb|model/gltf-binary
stpz|model/step+zip
ram|audio/x-pn-realaudio
stpx|model/step+xml
mxl|application/vnd.recordare.musicxml
vis|application/vnd.visionary
rar|application/x-rar-compressed
viv|video/vnd.vivo
cdf|application/x-netcdf
ipk|application/vnd.shana.informed.package
ras|image/x-cmu-raster
tex|application/x-tex
ktr|application/vnd.kahootz
mxs|application/vnd.triscape.mxs
mxu|video/vnd.mpegurl
jxsc|image/jxsc
mjp2|video/mj2
ktx|image/ktx
ktz|application/vnd.kahootz
tfi|application/thraud+xml
cdx|chemical/x-cdx
cdy|application/vnd.cinderella
tfm|application/x-tex-tfm
xns|application/xcap-ns+xml
jxrs|image/jxrs
avif|image/avif
xltx|application/vnd.openxmlformats-officedocument.spreadsheetml.template
jpg2|image/jp2
aac|audio/x-aac
aab|application/x-authorware-bin
ahead|application/vnd.ahead.space
gml|application/gml+xml
tfx|image/tiff-fx
aam|application/x-authorware-map
x3db|model/x3d+fastinfoset
tga|image/x-tga
cer|application/pkix-cert
aas|application/x-authorware-seg
gmx|application/vnd.gmx
xltm|application/vnd.ms-excel.template.macroenabled.12
xop|application/xop+xml
jpeg|image/jpeg
xlsx|application/vnd.openxmlformats-officedocument.spreadsheetml.sheet
c|text/x-c
irm|application/vnd.ibm.rights-management
irp|application/vnd.irepository.package+xml
f|text/x-fortran
h|text/x-c
xpi|application/x-xpinstall
p|text/x-pascal
cfs|application/x-cfs-compressed
s|text/x-asm
xpm|image/x-xpixmap
t|text/troff
rdf|application/rdf+xml
xpl|application/xproc+xml
xlsm|application/vnd.ms-excel.sheet.macroenabled.12
abw|application/x-abiword
kwd|application/vnd.kde.kword
xps|application/vnd.ms-xpsdocument
xpr|application/vnd.is-xpr
xlsb|application/vnd.ms-excel.sheet.binary.macroenabled.12
xpw|application/vnd.intercon.formnet
acc|application/vnd.americandynamics.acc
xpx|application/vnd.intercon.formnet
ace|application/x-ace-compressed
iso|application/x-iso9660-image
jpgv|video/jpeg
scss|text/x-scss
cgm|image/cgm
rdz|application/vnd.data-vision.rdz
kwt|application/vnd.kde.kword
potm|application/vnd.ms-powerpoint.template.macroenabled.12
deploy|application/octet-stream
tif|image/tiff
acu|application/vnd.acucobol
pac|application/x-ns-proxy-autoconfig
pskcxml|application/pskc+xml
sldm|application/vnd.ms-powerpoint.slide.macroenabled.12
sldx|application/vnd.openxmlformats-officedocument.presentationml.slide
rep|application/vnd.businessobjects
elc|application/octet-stream
jpgm|video/jpm
gph|application/vnd.flographit
i2g|application/vnd.intergeo
res|application/x-dtbresource+xml
xbap|application/x-ms-xbap
pas|text/x-pascal
itp|application/vnd.shana.informed.formtemplate
x3dz|model/x3d+xml
paw|application/vnd.pawaafile
its|application/its+xml
chm|application/vnd.ms-htmlhelp
adp|audio/adpcm
list|text/plain
gramps|application/x-gramps-xml
gpx|application/gpx+xml
uris|text/uri-list
pbd|application/vnd.powerbuilder6
pbm|image/x-portable-bitmap
x3dv|model/x3d-vrml
gqf|application/vnd.grafeq
emf|image/emf
cif|chemical/x-cif
cii|application/vnd.anser-web-certificate-issue-initiation
pcurl|application/vnd.curl.pcurl
eml|message/rfc822
cil|application/vnd.ms-artgalry
gqs|application/vnd.grafeq
xsd|application/xml
vob|video/x-ms-vob
rgb|image/x-rgb
aep|application/vnd.audiograph
xsl|application/xslt+xml
pcf|application/x-font-pcf
urls|text/uri-list
xsm|application/vnd.syncml+xml
emz|application/x-msmetafile
x32|application/x-authorware-bin
sv4crc|application/x-sv4crc
pcl|application/vnd.hp-pcl
vor|application/vnd.stardivision.writer
gre|application/vnd.geometry-explorer
vox|application/x-authorware-bin
pct|image/x-pict
mseq|application/vnd.mseq
ivp|application/vnd.immervision-ivp
pcx|image/x-pcx
wadl|application/vnd.sun.wadl+xml
ivu|application/vnd.immervision-ivu
afm|application/x-font-type1
grv|application/vnd.groove-injector
afp|application/vnd.ibm.modcap
cjs|application/node
pdb|application/x-pilot
geojson|application/geo+json
pde|text/x-processing
pdf|application/pdf
potx|application/vnd.openxmlformats-officedocument.presentationml.template
coffee|text/coffeescript
gsf|application/x-font-ghostscript
ngdat|application/vnd.nokia.n-gage.data
styl|text/stylus
eol|audio/vnd.digital-winds
movie|video/x-sgi-movie
x3d|model/x3d+xml
slim|text/slim
eot|application/vnd.ms-fontobject
rif|application/reginfo+xml
xul|application/vnd.mozilla.xul+xml
uvvz|application/vnd.dece.zip
uvvx|application/vnd.dece.unspecified
uvvu|video/vnd.uvvu.mp4
tmo|application/vnd.tmobile-livetv
uvvv|video/vnd.dece.video
rip|audio/vnd.rip
cla|application/vnd.claymore
pem|application/x-x509-ca-cert
sass|text/x-sass
ris|application/x-research-info-systems
gtm|application/vnd.groove-tool-message
uvvi|image/vnd.dece.graphic
list3820|application/vnd.ibm.modcap
uvvg|image/vnd.dece.graphic
uvvh|video/vnd.dece.hd
clp|application/x-msclip
uvvf|application/vnd.dece.data
uvvs|video/vnd.dece.sd
eps|application/postscript
uvvt|application/vnd.dece.ttml+xml
pfa|application/x-font-type1
gtw|model/vnd.gtw
g2w|application/vnd.geoplan
pfb|application/x-font-type1
uvvp|video/vnd.dece.pd
xvm|application/xv+xml
uvvm|video/vnd.dece.mobile
heifs|image/heif-sequence
install|application/x-install-instructions
h261|video/h261
pfm|application/x-font-type1
spot|text/vnd.in3d.spot
h263|video/h263
cmc|application/vnd.cosmocaller
h264|video/h264
uvvd|application/vnd.dece.data
uvva|audio/vnd.dece.audio
pfr|application/font-tdpfr
nbp|application/vnd.wolfram.player
aif|audio/x-aiff
dcurl|text/vnd.curl.dcurl
pfx|application/x-pkcs12
cml|chemical/x-cml
es3|application/vnd.eszigno3+xml
xwd|image/x-xwindowdump
vsd|application/vnd.visio
cmp|application/vnd.yellowriver-custom-menu
vsf|application/vnd.vsf
vmdk|application/x-virtualbox-vmdk
g3w|application/vnd.geospace
air|application/vnd.adobe.air-application-installer-package+zip
ait|application/vnd.dvb.ait
cmx|image/x-cmx
odft|application/vnd.oasis.opendocument.formula-template
listafp|application/vnd.ibm.modcap
pcap|application/vnd.tcpdump.pcap
vst|application/vnd.visio
pgn|application/x-chess-pgn
fe_launch|application/vnd.denovo.fcselayout-link
vss|application/vnd.visio
pgm|image/x-portable-graymap
pgp|application/pgp-encrypted
mobi|application/x-mobipocket-ebook
vsw|application/vnd.visio
xdssc|application/dssc+xml
nitf|application/vnd.nitf
ncx|application/x-dtbncx+xml
et3|application/vnd.eszigno3+xml
rlc|image/vnd.fujixerox.edmics-rlc
vtf|image/vnd.valve.source.texture
rld|application/resource-lists-diff+xml
toml|application/toml
tpl|application/vnd.groove-tool-template
esa|application/vnd.osgi.subsystem
shar|application/x-shar
vtu|model/vnd.vtu
vtt|text/vtt
esf|application/vnd.epson.esf
cryptonote|application/vnd.rig.cryptonote
cod|application/vnd.rim.cod
tpt|application/vnd.trid.tpt
php|application/x-httpd-php
atom|application/atom+xml
com|application/x-msdownload
mods|application/mods+xml
pic|image/x-pict
rmi|audio/midi
x3dbz|model/x3d+binary
pages|application/x-iwork-pages-sffpages
gxf|application/gxf
rmp|audio/x-pn-realaudio-plugin
heics|image/heic-sequence
xyz|chemical/x-xyz
rms|application/vnd.jcp.javame.midlet-rms
buffer|application/octet-stream
musicxml|application/vnd.recordare.musicxml+xml
gxt|application/vnd.geonext
tra|application/vnd.trueapp
vbox|application/x-virtualbox-vbox
cpp|text/x-c
cpt|application/mac-compactpro
rnc|application/relax-ng-compact-syntax
etx|text/x-setext
rng|application/xml
less|text/less
lbe|application/vnd.llamagraphics.life-balance.exchange+xml
trm|application/x-msterminal
lbd|application/vnd.llamagraphics.life-balance.desktop
cdxml|application/vnd.chemdraw+xml
nfo|text/x-nfo
bdoc|application/x-bdoc
pkpass|application/vnd.apple.pkpass
rp9|application/vnd.cloanto.rp9
ami|application/vnd.amiga.ami
tiff|image/tiff
tsd|application/timestamped-data
roa|application/rpki-roa
amr|audio/amr
musd|application/mmt-usd+xml
pkg|application/octet-stream
pki|application/pkixcmp
eva|application/x-eva
teacher|application/vnd.smart.teacher
crd|application/x-mscardfile
tsv|text/tab-separated-values
t38|image/t38
dump|application/octet-stream
crl|application/pkix-crl
ttc|font/collection
crt|application/x-x509-ca-cert
plc|application/vnd.mobius.plc
manifest|text/cache-manifest
plb|application/vnd.3gpp.pic-bw-large
ttf|font/ttf
crx|application/x-chrome-extension
evy|application/x-envoy
djvu|image/vnd.djvu
plf|application/vnd.pocketlearn
ttl|text/turtle
gtar|application/x-gtar
rpm|application/x-redhat-package-manager
application|application/x-ms-application
pls|application/pls+xml
csh|application/x-csh
jnlp|application/x-java-jnlp-file
xslt|application/xslt+xml
csl|application/vnd.citationstyles.style+xml
shex|text/shex
inkml|application/inkml+xml
onepkg|application/onenote
csp|application/vnd.commonspace
css|text/css
cst|application/x-director
apng|image/apng
csv|text/csv
xspf|application/xspf+xml
jad|text/vnd.sun.j2me.app-descriptor
mbox|application/mbox
pml|application/vnd.ctc-posml
rmvb|application/vnd.rn-realmedia-vbr
exe|application/x-msdownload
java|text/x-java-source
ccxml|application/ccxml+xml
exi|application/exi
jam|application/vnd.jam
ppam|application/vnd.ms-powerpoint.addin.macroenabled.12
jar|application/java-archive
docm|application/vnd.ms-word.document.macroenabled.12
les|application/vnd.hhe.lesson-player
exp|application/express
ez2|application/vnd.ezpix-album
apk|application/vnd.android.package-archive
onetoc2|application/onenote
exr|image/aces
ez3|application/vnd.ezpix-package
ext|application/vnd.novadigm.ext
iota|application/vnd.astraea-software.iota
apr|application/vnd.lotus-approach
distz|application/octet-stream
png|image/png
ptid|application/vnd.pvi.ptid1
texinfo|application/x-texinfo
pnm|image/x-portable-anymap
obgx|application/vnd.openblox.game+xml
twd|application/vnd.simtech-mindmapper
rsd|application/rsd+xml
rcprofile|application/vnd.ipunplugged.rcprofile
c4d|application/vnd.clonk.c4group
rss|application/rss+xml
arc|application/x-freearc
c4f|application/vnd.clonk.c4group
pot|application/vnd.ms-powerpoint
lgr|application/lgr+xml
c4g|application/vnd.clonk.c4group
arj|application/x-arj
markdown|text/markdown
c4p|application/vnd.clonk.c4group
txd|application/vnd.genomatix.tuxedo
txf|application/vnd.mobius.txf
lha|application/x-lzh-compressed
rtf|text/rtf
c4u|application/vnd.clonk.c4group
ppd|application/vnd.cups-ppd
gram|application/srgs
ppm|image/x-portable-pixmap
docx|application/vnd.openxmlformats-officedocument.wordprocessingml.document
asc|application/pgp-signature
txt|text/plain
pps|application/vnd.ms-powerpoint
ppt|application/vnd.ms-powerpoint
asf|video/x-ms-asf
nlu|application/vnd.neurolanguage.nlu
rtx|text/richtext
asm|text/x-asm
m3u8|application/vnd.apple.mpegurl
aso|application/vnd.accpac.simply.aso
cpio|application/x-cpio
iges|model/iges
pqa|application/vnd.palm
cww|application/prs.cww
onetoc|application/onenote
asx|video/x-ms-asf
run|application/x-makeself
nml|application/vnd.enliven
p10|application/pkcs10
p12|application/x-pkcs12
atc|application/vnd.acucorp
hal|application/vnd.hal+xml
wasm|application/wasm
msty|application/vnd.muvee.style
ecma|application/ecmascript
cdbcmsg|application/vnd.contact.cmsg
cxt|application/x-director
yaml|text/yaml
prc|application/x-pilot
pre|application/vnd.lotus-freelance
cxx|text/x-c
atx|application/vnd.antix.game-component
prf|application/pics-rules
nnd|application/vnd.noblenet-directory
grxml|application/srgs+xml
nns|application/vnd.noblenet-sealer
nnw|application/vnd.noblenet-web
hbs|text/x-handlebars-template
psb|application/vnd.3gpp.pic-bw-small
psd|image/vnd.adobe.photoshop
psf|application/x-font-linux-psf
relo|application/p2p-overlay+xml
book|application/vnd.framemaker
hbci|application/vnd.hbci
avi|video/x-msvideo
wad|application/x-doom
ssdl|application/ssdl+xml
ustar|application/x-ustar
jhc|image/jphc
pti|image/prs.pti
tcap|application/vnd.3gpp2.tcap
war|application/java-archive
hdd|application/x-virtualbox-hdd
hdf|application/x-hdf
litcoffee|text/coffeescript
wav|audio/x-wav
ufdl|application/vnd.ufdl
xhtml|application/xhtml+xml
wax|audio/x-ms-wax
setreg|application/set-registration-initiation
npx|image/vnd.net-fpx
yang|application/yang
pub|application/x-mspublisher
bmml|application/vnd.balsamiq.bmml+xml
setpay|application/set-payment-initiation
wbs|application/vnd.criticaltools.wbs+xml
jsonld|application/ld+json
gslides|application/vnd.google-apps.presentation
gsheet|application/vnd.google-apps.spreadsheet
midi|audio/midi
pvb|application/vnd.3gpp.pic-bw-var
wcm|application/vnd.ms-works
lnk|application/x-ms-shortcut
dssc|application/dssc+der
wdb|application/vnd.ms-works
fbs|image/vnd.fastbidsheet
u8hdr|message/global-headers
nsc|application/x-conference
nsf|application/vnd.lotus-notes
wdp|image/vnd.ms-photo
log|text/plain
pwn|application/vnd.3m.post-it-notes
sdkm|application/vnd.solent.sdkm+xml
azf|application/vnd.airzip.filesecure.azf
onetmp|application/onenote
fcs|application/vnd.isac.fcs
luac|application/x-lua-bytecode
udeb|application/x-debian-package
woff2|font/woff2
azs|application/vnd.airzip.filesecure.azs
azv|image/vnd.airzip.accelerator.azv
azw|application/vnd.amazon.ebook
sdkd|application/vnd.solent.sdkm+xml
yin|application/yin+xml
ntf|application/vnd.nitf
hsj2|image/hsj2
lostxml|application/lost+xml
fdf|application/vnd.fdf
jls|image/jls
jlt|application/vnd.hp-jlyt
chat|application/x-chat
fdt|application/fdt+xml
pya|audio/vnd.ms-playready.media.pya
p7b|application/x-pkcs7-certificates
ubj|application/ubjson
p7c|application/pkcs7-mime
usdz|model/vnd.usdz+zip
p7m|application/pkcs7-mime
daf|application/vnd.mobius.daf
dae|model/vnd.collada+xml
p7r|application/x-pkcs7-certreqresp
pyv|video/vnd.ms-playready.media.pyv
p7s|application/pkcs7-signature
fg5|application/vnd.fujitsu.oasysgp
scurl|text/vnd.curl.scurl
clkp|application/vnd.crick.clicker.palette
lrf|application/octet-stream
jng|image/x-jng
wgt|application/widget
lrm|application/vnd.ms-lrm
clkk|application/vnd.crick.clicker.keyboard
dtshd|audio/vnd.dts.hd
dbf|application/vnd.dbf
dbk|application/docbook+xml
jp2|image/jp2
fh5|image/x-freehand
dd2|application/vnd.oma.dd2+xml
fh4|image/x-freehand
fh7|image/x-freehand
clkx|application/vnd.crick.clicker
clkw|application/vnd.crick.clicker.wordbank
clkt|application/vnd.crick.clicker.template
blorb|application/x-blorb
fgd|application/x-director
acutc|application/vnd.acucorp
ssml|application/ssml+xml
ecelp9600|audio/vnd.nuera.ecelp9600
dcr|application/x-director
pclxl|application/vnd.hp-pclxl
vxml|application/voicexml+xml
saf|application/vnd.yamaha.smaf-audio
yml|text/yaml
ymp|text/x-suse-ymp
jpe|image/jpeg
ltf|application/vnd.frogans.ltf
jpg|image/jpeg
fhc|image/x-freehand
jpf|image/jpx
jph|image/jph
ddd|application/vnd.fujixerox.ddd
wmlsc|application/vnd.wap.wmlscriptc
jpm|video/jpm
ddf|application/vnd.syncml.dmddf+xml
3dml|text/vnd.in3d.3dml
jsonml|application/jsonml+json
hlp|application/winhlp
jardiff|application/x-java-archive-diff
ufd|application/vnd.ufdl
dds|image/vnd.ms-dds
jpx|image/jpx
lua|text/x-lua
stpxz|model/step-xml+zip
deb|application/x-debian-package
smzip|application/vnd.stepmania.package
3ds|image/x-3ds
def|text/plain
fig|application/x-xfig
mime|message/rfc822
susp|application/vnd.sus-calendar
der|application/x-x509-ca-cert
bat|application/x-msdownload
scd|application/x-msschedule
nzb|application/x-nzb
sbml|application/sbml+xml
scm|application/vnd.lotus-screencam
wks|application/vnd.ms-works
3g2|video/3gpp2
scq|application/scvp-cv-request
ac|application/vnd.nokia.n-gage.ac+xml
scs|application/scvp-cv-response
bcpio|application/x-bcpio
lvp|audio/vnd.lucent.voice
ai|application/postscript
ttml|application/ttml+xml
trig|application/trig
sda|application/vnd.stardivision.draw
sdd|application/vnd.stardivision.impress
sdc|application/vnd.stardivision.calc
au|audio/basic
aw|application/applixware
ecelp7470|audio/vnd.nuera.ecelp7470
raml|application/raml+yaml
sdp|application/sdp
dgc|application/x-dgc-compressed
lwp|application/vnd.lotus-wordpro
sdw|application/vnd.stardivision.writer
sfd-hdstx|application/vnd.hydrostatix.sof-data
wma|audio/x-ms-wma
pptm|application/vnd.ms-powerpoint.presentation.macroenabled.12
sea|application/x-sea
jsx|text/jsx
wmd|application/x-ms-wmd
ppsx|application/vnd.openxmlformats-officedocument.presentationml.slideshow
wmf|image/wmf
see|application/vnd.seemail
wsdl|application/wsdl+xml
rapd|application/route-apd+xml
epub|application/epub+zip
wml|text/vnd.wap.wml
bz|application/x-bzip
qam|application/vnd.epson.quickanime
3gp|video/3gpp
dotx|application/vnd.openxmlformats-officedocument.wordprocessingml.template
cc|text/x-c
ser|application/java-serialized-object
lasxml|application/vnd.las.las+xml
wmv|video/x-ms-wmv
fli|video/x-fli
wmx|video/x-ms-wmx
bdf|application/x-font-bdf
wmz|application/x-msmetafile
flo|application/vnd.micrografx.flo
hps|application/vnd.hp-hps
bdm|application/vnd.syncml.dm+wbxml
dotm|application/vnd.ms-word.template.macroenabled.12
ppsm|application/vnd.ms-powerpoint.slideshow.macroenabled.12
provx|application/provenance+xml
flw|application/vnd.kde.kivio
flv|video/x-flv
cu|application/cu-seeme
ipfix|application/ipfix
fly|text/vnd.fly
flx|text/vnd.fmi.flexstor
qbo|application/vnd.intu.qbo
dic|text/x-c
bed|application/vnd.realvnc.bed
sfs|application/vnd.spotfire.sfs
sfv|text/x-sfv
dp|application/vnd.osgi.dp
dir|application/x-director
latex|application/x-latex
hqx|application/mac-binhex40
dis|application/vnd.mobius.dis
sgi|image/sgi
sgm|text/sgml
sgl|application/vnd.stardivision.writer-global
fnc|application/vnd.frogans.fnc
gnumeric|application/x-gnumeric
lzh|application/x-lzh-compressed
mk3d|video/x-matroska
oa3|application/vnd.fujitsu.oasys3
oa2|application/vnd.fujitsu.oasys2
wpd|application/vnd.wordperfect
g3|image/g3fax
bh2|application/vnd.fujitsu.oasysprs
es|application/ecmascript
shf|application/shf+xml
pptx|application/vnd.openxmlformats-officedocument.presentationml.presentation
djv|image/vnd.djvu
wpl|application/vnd.ms-wpl
joda|application/vnd.joost.joda-archive
ez|application/andrew-inset
u8msg|message/global
mxmf|audio/mobile-xmf
mxml|application/xv+xml
hjson|application/hjson
wps|application/vnd.ms-works
frame|application/vnd.framemaker
ogex|model/vnd.opengex
ulx|application/x-glulx
btif|image/prs.btif
fh|image/x-freehand
webmanifest|application/manifest+json
fm|application/vnd.framemaker
smil|application/smil+xml
for|text/x-fortran
fo|application/vnd.software602.filler.form+xml
wqd|application/vnd.wqd
swidtag|application/swid+xml
sid|image/x-mrsid-image
sig|application/pgp-signature
umj|application/vnd.umajin
omdoc|application/omdoc+xml
htc|text/x-component
sil|audio/silk
json|application/json
sis|application/vnd.symbian.install
cdfx|application/cdfx+xml
class|application/java-vm
sit|application/x-stuffit
meta4|application/metalink4+xml
oas|application/vnd.fujitsu.oasys
htm|text/html
siv|application/sieve
jxs|image/jxs
dll|application/x-msdownload
jxr|image/jxr
mrcx|application/marcxml+xml
wri|application/x-mswrite
fpx|image/vnd.fpx
gv|text/vnd.graphviz
obd|application/x-msbinder
wrl|model/vrml
gz|application/gzip
obj|model/obj
dmg|application/x-apple-diskimage
hh|text/x-c
qfx|application/vnd.intu.qfx
bin|application/octet-stream
dmp|application/vnd.tcpdump.pcap
wsc|message/vnd.wfa.wsc
maei|application/mmt-aei+xml
dms|application/octet-stream
portpkg|application/vnd.macports.portpkg
3mf|model/3mf
skd|application/vnd.koan
mads|application/mads+xml
skm|application/vnd.koan
texi|application/x-texinfo
dna|application/vnd.dna
hvd|application/vnd.yamaha.hv-dic
skp|application/vnd.koan
text|text/plain
skt|application/vnd.koan
rsheet|application/urc-ressheet+xml
unityweb|application/vnd.unity
hvp|application/vnd.yamaha.hv-voice
wtb|application/vnd.webturbo
hvs|application/vnd.yamaha.hv-script
xvml|application/xv+xml
in|text/plain
torrent|application/x-bittorrent
mathml|application/mathml+xml
rpst|application/vnd.nokia.radio-preset
rpss|application/vnd.nokia.radio-presets
odb|application/vnd.oasis.opendocument.database
oda|application/oda
odc|application/vnd.oasis.opendocument.chart
odf|application/vnd.oasis.opendocument.formula
odg|application/vnd.oasis.opendocument.graphics
odi|application/vnd.oasis.opendocument.image
slm|text/slim
fsc|application/vnd.fsc.weblaunch
ecelp4800|audio/vnd.nuera.ecelp4800
doc|application/msword
odm|application/vnd.oasis.opendocument.text-master
slt|application/vnd.epson.salt
odp|application/vnd.oasis.opendocument.presentation
sls|application/route-s-tsid+xml
sieve|application/sieve
odt|application/vnd.oasis.opendocument.text
ods|application/vnd.oasis.opendocument.spreadsheet
fst|image/vnd.fst
dot|application/msword
js|application/javascript
chrt|application/vnd.kde.kchart
w3d|application/x-director
atomdeleted|application/atomdeleted+xml
smf|application/vnd.stardivision.math
smi|application/smil+xml
efif|application/vnd.picsel
mag|application/vnd.ecowin.chart
1km|application/vnd.1000minds.decision-model+xml
ftc|application/vnd.fluxtime.clip
blb|application/x-blorb
fti|application/vnd.anser-web-funds-transfer-initiation
dpg|application/vnd.dpgraph
mc1|application/vnd.medcalcdata
xenc|application/xenc+xml
man|text/troff
map|application/json
smv|video/x-smv
mar|application/octet-stream
teicorpus|application/tei+xml
snd|audio/basic
xhvml|application/xv+xml
snf|application/x-font-snf
vrml|model/vrml
uri|text/uri-list
mbk|application/vnd.mobius.mbk
wvx|video/x-ms-wvx
bmi|application/vnd.bmi
bmp|image/x-ms-bmp
n3|text/n3
wspolicy|application/wspolicy+xml
oga|audio/ogg
dist|application/octet-stream
zirz|application/vnd.zul
mpga|audio/mpeg
ogg|audio/ogg
mcd|application/vnd.mcd
uoml|application/vnd.uoml+xml
dra|audio/vnd.dra
ma|application/mathematica
mb|application/mathematica
u32|application/x-authorware-bin
md|text/markdown
oxps|application/oxps
me|text/troff
wbmp|image/vnd.wap.wbmp
ogv|video/ogg
ogx|application/ogg
mpg4|video/mp4
fvt|video/vnd.fvt
ms|text/troff
spc|application/x-pkcs7-certificates
spf|application/vnd.yamaha.smaf-phrase
f4v|video/x-f4v
mdb|application/x-msaccess
spl|application/x-futuresplash
woff|font/woff
spp|application/scvp-vp-response
mdi|image/vnd.ms-modi
nb|application/mathematica
spq|application/scvp-vp-request
nc|application/x-netcdf
dsc|text/prs.lines.tag
mpeg|video/mpeg
utz|application/vnd.uiq.theme
spx|audio/ogg
mdx|text/mdx
nq|application/n-quads
nt|application/n-triples
f77|text/x-fortran
p8|application/pkcs8
sensmlx|application/sensml+xml
box|application/vnd.previewsystems.box
boz|application/x-bzip2
sql|application/x-sql
ktx2|image/ktx2
dtb|application/x-dtbook+xml
dtd|application/xml-dtd
bpk|application/octet-stream
kar|audio/midi
mesh|model/mesh
fxp|application/vnd.adobe.fxp
uva|audio/vnd.dece.audio
uvd|application/vnd.dece.data
dts|audio/vnd.dts
uvf|application/vnd.dece.data
src|application/x-wais-source
uvh|video/vnd.dece.hd
uvg|image/vnd.dece.graphic
uvi|image/vnd.dece.graphic
uvm|video/vnd.dece.mobile
uvp|video/vnd.dece.pd
uvt|application/vnd.dece.ttml+xml
uvs|video/vnd.dece.sd
srt|application/x-subrip
uvv|video/vnd.dece.video
mfm|application/vnd.mfmp
uvu|video/vnd.uvvu.mp4
uvx|application/vnd.dece.unspecified
sru|application/sru+xml
srx|application/sparql-results+xml
uvz|application/vnd.dece.zip
mft|application/rpki-manifest
pl|application/x-perl
f90|text/x-fortran
pm|application/x-perl
rsat|application/atsc-rsat+xml
curl|text/vnd.curl
ps|application/postscript
sse|application/vnd.kodak-descriptor
b16|image/vnd.pco.b16
ssf|application/vnd.epson.ssf
mpkg|application/vnd.apple.installer+xml
dvb|video/vnd.dvb.file
dvi|application/x-dvi
mgp|application/vnd.osgeo.mapguide.package
xlam|application/vnd.ms-excel.addin.macroenabled.12
fzs|application/vnd.fuzzysheet
mgz|application/vnd.proteus.magazine
csml|chemical/x-csml
fcdt|application/vnd.adobe.formscentral.fcdt
std|application/vnd.sun.xml.draw.template
stc|application/vnd.sun.xml.calc.template
qt|video/quicktime
mets|application/mets+xml
stf|application/vnd.wt.stf
gltf|model/gltf+json
sti|application/vnd.sun.xml.impress.template
stl|model/stl
stk|application/hyperstudio
vcard|text/vcard
ra|audio/x-realaudio
dwd|application/atsc-dwd+xml
str|application/vnd.pg.format
123|application/vnd.lotus-1-2-3
zaz|application/vnd.zzazz.deck+xml
dwf|model/vnd.dwf
mj2|video/mj2
qps|application/vnd.publishare-delta-tree
dwg|image/vnd.dwg
stw|application/vnd.sun.xml.writer.template
mcurl|text/vnd.curl.mcurl
rl|application/resource-lists+xml
rm|application/vnd.rn-realmedia
bsp|model/vnd.valve.source.compiled-map
rq|application/sparql-query
t3|application/x-t3vm-image
rs|application/rls-services+xml
sub|text/vnd.dvb.subtitle
cmdf|chemical/x-cmdf
seed|application/vnd.fdsn.seed
json5|application/json5
karbon|application/vnd.kde.karbon
mie|application/x-mie
mid|audio/midi
mif|application/vnd.mif
s3m|audio/s3m
metalink|application/metalink+xml
sc|application/vnd.ibm.secure-container
sus|application/vnd.sus-calendar
dxf|image/vnd.dxf
sh|application/x-sh
sm|application/vnd.stepmania.stepchart
x_b|model/vnd.parasolid.transmit.binary
so|application/octet-stream
dxp|application/vnd.spotfire.dxp
key|application/x-iwork-keynote-sffkey
dxr|application/x-director
svd|application/vnd.svd
svc|application/vnd.dvb.service
st|application/vnd.sailingtracker.track
twds|application/vnd.simtech-mindmapper
svg|image/svg+xml
maker|application/vnd.framemaker
mseed|application/vnd.fdsn.mseed
silo|model/mesh
x_t|model/vnd.parasolid.transmit.text
td|application/urc-targetdesc+xml
xaml|application/xaml+xml
kfo|application/vnd.kde.kformula
mjs|application/javascript
tk|application/x-tcl
link66|application/vnd.route66.link66+xml
swa|application/x-director
fxpl|application/vnd.adobe.fxp
tr|text/troff
ts|video/mp2t
webapp|application/x-web-app-manifest+json
mka|audio/x-matroska
swf|application/x-shockwave-flash
swi|application/vnd.aristanetworks.swi
mkd|text/x-markdown
numbers|application/x-iwork-numbers-sffnumbers
icc|application/vnd.iccprofile
ice|x-conference/x-cooltalk
c11amz|application/vnd.cluetrust.cartomobile-config-pkg
icm|application/vnd.iccprofile
ico|image/x-icon
mks|video/x-matroska
ics|text/calendar
mkv|video/x-matroska
emotionml|application/emotionml+xml
sxd|application/vnd.sun.xml.draw
sxc|application/vnd.sun.xml.calc
svgz|image/svg+xml
uu|text/x-uuencode
sxg|application/vnd.sun.xml.writer.global
opf|application/oebps-package+xml
sxi|application/vnd.sun.xml.impress
xap|application/x-silverlight-app
xar|application/vnd.xara
drle|image/dicom-rle
sxm|application/vnd.sun.xml.math
xav|application/xcap-att+xml
fits|image/fits
c11amc|application/vnd.cluetrust.cartomobile-config
mlp|application/vnd.dolby.mlp
sxw|application/vnd.sun.xml.writer
xbd|application/vnd.fujixerox.docuworks.binder
kia|application/vnd.kidspiration
xbm|image/x-xbitmap
mmd|application/vnd.chipnuts.karaoke-mmd
aiff|audio/x-aiff
sgml|text/sgml
mmf|application/vnd.smaf
gac|application/vnd.groove-account
aifc|audio/x-aiff
ief|image/ief
mml|text/mathml
wg|application/vnd.pmi.widget
gam|application/x-tads
mmr|image/vnd.fujixerox.edmics-mmr
wm|video/x-ms-wm
xca|application/xcap-caps+xml
bz2|application/x-bzip2
senmlx|application/senml+xml
davmount|application/davmount+xml
ifb|text/calendar
org|text/x-org
heic|image/heic
mng|video/x-mng
xcs|application/calendar+xml
heif|image/heif
wmls|text/vnd.wap.wmlscript
dataless|application/vnd.fdsn.seed
mp2|audio/mpeg
mp4|video/mp4
ifm|application/vnd.shana.informed.formdata
mp3|audio/mpeg
xm|audio/xm
hej2|image/hej2k
gbr|application/rpki-ghostbusters
xo|application/vnd.olpc-sugar
z1|application/x-zmachine
u8dsn|message/global-delivery-status
z2|application/x-zmachine
mny|application/x-msmoney
z3|application/x-zmachine
wmlc|application/vnd.wap.wmlc
z4|application/x-zmachine
z5|application/x-zmachine
xdf|application/xcap-diff+xml
z6|application/x-zmachine
z7|application/x-zmachine
z8|application/x-zmachine
qwd|application/vnd.quark.quarkxpress
u8mdn|message/global-disposition-notification
xdm|application/vnd.syncml.dm+xml
xz|application/x-xz
osf|application/vnd.yamaha.openscoreformat
gca|application/x-gca-compressed
held|application/atsc-held+xml
xdp|application/vnd.adobe.xdp+xml
osm|application/vnd.openstreetmap.data+xml
xdw|application/vnd.fujixerox.docuworks
conf|text/plain
igm|application/vnd.insors.igm
sisx|application/vnd.symbian.install
igl|application/vnd.igloader
qwt|application/vnd.quark.quarkxpress
mp21|application/mp21
igs|model/iges
mov|video/quicktime
kpxx|application/vnd.ds-keypoint
qxb|application/vnd.quark.quarkxpress
igx|application/vnd.micrografx.igx
qxd|application/vnd.quark.quarkxpress
xel|application/xcap-el+xml
otc|application/vnd.oasis.opendocument.chart-template
mpd|application/dash+xml
zip|application/zip
otf|font/otf
mpc|application/vnd.mophun.certificate
oth|application/vnd.oasis.opendocument.text-web
zir|application/vnd.zul
otg|application/vnd.oasis.opendocument.graphics-template
7z|application/x-7z-compressed
mpe|video/mpeg
xer|application/patch-ops-error+xml
qxl|application/vnd.quark.quarkxpress
oti|application/vnd.oasis.opendocument.image-template
mpg|video/mpeg
thmx|application/vnd.ms-officetheme
mpn|application/vnd.mophun.application
otp|application/vnd.oasis.opendocument.presentation-template
mpm|application/vnd.blueice.multipass
mpp|application/vnd.ms-project
qxt|application/vnd.quark.quarkxpress
ott|application/vnd.oasis.opendocument.text-template
gdl|model/vnd.gdl
ots|application/vnd.oasis.opendocument.spreadsheet-template
mpt|application/vnd.ms-project
osfpvg|application/vnd.yamaha.openscoreformat.osfpvg+xml
mpy|application/vnd.ibm.minipay
taglet|application/vnd.mynfc
x3dvz|model/x3d+vrml
gdoc|application/vnd.google-apps.document
iif|application/vnd.shana.informed.interchange
flac|audio/x-flac
kml|application/vnd.google-earth.kml+xml
m13|application/x-msmediaview
geo|application/vnd.dynageo
dart|application/vnd.dart
m14|application/x-msmediaview
sema|application/vnd.sema
mqy|application/vnd.mobius.mqy
vcd|application/x-cdlink
ear|application/java-archive
htke|application/vnd.kenameaapp
vcf|text/x-vcard
kmz|application/vnd.google-earth.kmz
gex|application/vnd.geometry-explorer
vcg|application/vnd.groove-vcard
ova|application/x-virtualbox-ova
semd|application/vnd.semd
kdbx|application/x-keepass2
semf|application/vnd.semf
ovf|application/x-virtualbox-ovf
mrc|application/marc
mp2a|audio/mpeg
kne|application/vnd.kinar
vcs|text/x-vcalendar
n-gage|application/vnd.nokia.n-gage.symbian.install
vcx|application/vnd.vcx
knp|application/vnd.kinar
m21|application/mp21
sitx|application/x-stuffitx
opml|text/x-opml
vdi|application/x-virtualbox-vdi
disposition-notification|message/disposition-notification
msg|application/vnd.ms-outlook
msf|application/vnd.epson.msf
msi|application/x-msdownload
ggb|application/vnd.geogebra.file
msh|model/mesh
vds|model/vnd.sap.vds
spdx|text/spdx
owl|application/rdf+xml
xht|application/xhtml+xml
msm|application/octet-stream
msl|application/vnd.mobius.msl
roff|text/troff
msp|application/octet-stream
kon|application/vnd.kde.kontour
3gpp|video/3gpp
mp4s|application/mp4
m1v|video/mpeg
xif|image/vnd.xiff
ggt|application/vnd.geogebra.tool
mp4v|video/mp4
atomcat|application/atomcat+xml
html|text/html
zmm|application/vnd.handheld-entertainment+xml
m2a|audio/mpeg
tap|image/vnd.tencent.tap
tao|application/vnd.tao.intent-module-archive
vbox-extpack|application/x-virtualbox-vbox-extpack
mp4a|audio/mp4
ghf|application/vnd.groove-help
tar|application/x-tar
mtl|model/mtl
oxt|application/vnd.openofficeorg.extension
webp|image/webp
kpr|application/vnd.kde.kpresenter
mts|model/vnd.mts
kpt|application/vnd.kde.kpresenter
webm|video/webm
edm|application/vnd.novadigm.edm
m2v|video/mpeg
edx|application/vnd.novadigm.edx
cb7|application/x-cbr
m3a|audio/mpeg
weba|audio/webm
pkipath|application/pkix-pkipath
img|application/octet-stream
cab|application/vnd.ms-cab-compressed
gif|image/gif
xfdf|application/vnd.adobe.xfdf
caf|audio/x-caf
jade|text/jade
gim|application/vnd.groove-identity-message
mus|application/vnd.musician
appcache|text/cache-manifest
jxra|image/jxra
imp|application/vnd.accpac.simply.imp
ims|application/vnd.ms-ims
xfdl|application/vnd.xfdl
m3u|audio/x-mpegurl
cap|application/vnd.tcpdump.pcap
car|application/vnd.curl.car
cat|application/vnd.ms-pki.seccat
wbxml|application/vnd.wap.wbxml
sv4cpio|application/x-sv4cpio
mvb|application/x-msmediaview
m4a|audio/x-m4a
tcl|application/x-tcl
hpgl|application/vnd.hp-hpgl
rusd|application/route-usd+xml
cba|application/x-cbr
cdmic|application/cdmi-container
cdmid|application/cdmi-domain
ini|text/plain
cdmia|application/cdmi-capability
oprc|application/vnd.palm
ink|application/inkml+xml
m4p|application/mp4
mscml|application/mediaservercontrol+xml
mvt|application/vnd.mapbox-vector-tile
xla|application/vnd.ms-excel
jisp|application/vnd.jisp
m4s|video/iso.segment
xlc|application/vnd.ms-excel
m4v|video/x-m4v
m4u|video/vnd.mpegurl
cdmio|application/cdmi-object
cbr|application/x-cbr
vhd|application/x-virtualbox-vhd
xlf|application/xliff+xml
cbt|application/x-cbr
cdmiq|application/cdmi-queue
xlm|application/vnd.ms-excel
cbz|application/x-cbr
cdkey|application/vnd.mediastation.cdkey
mwf|application/vnd.mfer
xls|application/vnd.ms-excel